NO ./texture/wall_n.xpm
SO ./texture/wall_s.xpm
WE ./texture/wall_w.xpm
EA ./texture/wall_e.xpm
S ./texture/item.xpm

F 00,153,15
C 255,255,255




        1111111111111111111111111
        1000000000000000000000001
        1100000000000000000000001
        1000000200000000000000001
111111111000000000000000000000001
100000000000000000000000000001111
10000000000000000000000000001
10000000000000000000000000001
1000000000000N000000000000001
10000000000000000000000000001
10000000000000000001010000001
11000001110101011111011110101
11110111 1110111 101111010201
11111111 1111111 111111111111
